NO ./textures/1.xpm

SO ./textures/2.xpm

WE ./textures/3.xpm

EA ./textures/4.xpm

F 255,255,255

C 0,0,0


111111111111111111111111111111
1N10C010O010001000100010001001
101010101010101010101010101001
101010101010101010101010101001
101010101010101010101010101001
101010101010101010101010101001
101010101010101010101010101001
101010101010101010101010101001
101010101010101010101010101001
101010101010101010101010101001
101010101010101010101010101001
101010101010101010101010101001
101010101010101010101010101001
101010101010101010101010101001
100010C010O0100010001000100001
111111111111111111111111111111
